{
    "897": 417,
    "150": 418,
    "910": 419,
    "133": 420,
    "1633": 421,
    "1253": 422,
    "963": 423,
    "119": 424,
    "112": 425,
    "154": 426,
    "872": 427,
    "105": 428,
    "155": 429,
    "142": 430,
    "911": 431,
    "115": 432,
    "305": 433,
    "118": 434,
    "1519": 435,
    "877": 436,
    "696": 437,
    "122": 438,
    "895": 439,
    "172": 440,
    "181": 441,
    "928": 442,
    "930": 443,
    "1612": 444,
    "941": 445,
    "946": 446,
    "104": 447,
    "1542": 448,
    "1257": 449,
    "148": 450,
    "157": 451,
    "162": 452,
    "161": 453,
    "163": 454,
    "1349": 455,
    "899": 456,
    "174": 457,
    "175": 458,
    "113": 459,
    "686": 460,
    "904": 461,
    "147": 462,
    "149": 463,
    "152": 464,
    "903": 465,
    "902": 466,
    "167": 467,
    "267": 468,
    "905": 469,
    "151": 470,
    "109": 471,
    "900": 472,
    "901": 473,
    "160": 474,
    "111": 475,
    "124": 476,
    "126": 477,
    "1350": 478,
    "166": 479,
    "165": 480,
    "1388": 481,
    "128": 482,
    "1389": 483,
    "171": 484,
    "170": 485,
    "131": 486,
    "177": 487,
    "185": 488,
    "137": 489,
    "1346": 490,
    "1347": 491,
    "1348": 492,
    "965": 493,
    "879": 494,
    "108": 495,
    "138": 496,
    "352": 497,
    "1247": 498,
    "169": 499,
    "886": 500,
    "878": 501,
    "884": 502,
    "890": 503,
    "665": 504,
    "883": 505,
    "1124": 506,
    "891": 507,
    "880": 508,
    "892": 509,
    "894": 510,
    "1354": 511,
    "874": 512,
    "468": 513,
    "973": 514,
    "876": 515,
    "107": 516,
    "896": 517,
    "127": 518,
    "916": 519,
    "182": 520,
    "915": 521,
    "914": 522,
    "919": 523,
    "918": 524,
    "913": 525,
    "917": 526,
    "920": 527,
    "927": 528,
    "922": 529,
    "178": 530,
    "926": 531,
    "924": 532,
    "921": 533,
    "925": 534,
    "923": 535,
    "1484": 536,
    "1632": 537,
    "1562": 538,
    "1634": 539,
    "125": 540,
    "700": 541,
    "940": 542,
    "524": 543,
    "814": 544,
    "382": 545,
    "1297": 546,
    "722": 547,
    "929": 548,
    "932": 549,
    "398": 550,
    "1380": 551,
    "800": 552,
    "974": 553,
    "184": 554,
    "971": 555,
    "939": 556,
    "1465": 557,
    "936": 558,
    "934": 559,
    "931": 560,
    "935": 561,
    "938": 562,
    "1539": 563,
    "937": 564,
    "1552": 565,
    "968": 566,
    "1357": 567,
    "1355": 568,
    "1613": 569,
    "1614": 570,
    "1615": 571,
    "944": 572,
    "1239": 573,
    "942": 574,
    "943": 575,
    "1541": 576,
    "952": 577,
    "949": 578,
    "957": 579,
    "1304": 580,
    "139": 581,
    "959": 582,
    "1526": 583,
    "967": 584,
    "955": 585,
    "300": 586,
    "313": 587,
    "176": 588,
    "302": 589,
    "956": 590,
    "953": 591,
    "960": 592,
    "296": 593,
    "295": 594,
    "954": 595,
    "958": 596,
    "1640": 597,
    "1543": 598,
    "1564": 599
}