{
    "897": 234,
    "150": 235,
    "910": 236,
    "133": 237,
    "1633": 238,
    "1253": 239,
    "963": 240,
    "119": 241,
    "112": 242,
    "154": 243,
    "872": 244,
    "105": 245,
    "155": 246,
    "142": 247,
    "911": 248,
    "115": 249,
    "305": 250,
    "118": 251,
    "1519": 252,
    "877": 253,
    "696": 254,
    "122": 255,
    "895": 256,
    "172": 257,
    "181": 258,
    "928": 259,
    "930": 260,
    "1612": 261,
    "941": 262,
    "946": 263,
    "104": 264,
    "1542": 265,
    "1257": 266,
    "148": 267,
    "157": 268,
    "162": 269,
    "161": 270,
    "163": 271,
    "1349": 272,
    "899": 273,
    "174": 274,
    "175": 275,
    "113": 276,
    "686": 277,
    "904": 278,
    "147": 279,
    "149": 280,
    "152": 281,
    "903": 282,
    "902": 283,
    "167": 284,
    "267": 285,
    "905": 286,
    "151": 287,
    "109": 288,
    "900": 289,
    "901": 290,
    "160": 291,
    "111": 292,
    "124": 293,
    "126": 294,
    "1350": 295,
    "166": 296,
    "165": 297,
    "1388": 298,
    "128": 299,
    "1389": 300,
    "171": 301,
    "170": 302,
    "131": 303,
    "177": 304,
    "185": 305,
    "137": 306,
    "1346": 307,
    "1347": 308,
    "1348": 309,
    "965": 310,
    "879": 311,
    "108": 312,
    "138": 313,
    "352": 314,
    "1247": 315,
    "169": 316,
    "886": 317,
    "878": 318,
    "884": 319,
    "890": 320,
    "665": 321,
    "883": 322,
    "1124": 323,
    "891": 324,
    "880": 325,
    "892": 326,
    "894": 327,
    "1354": 328,
    "874": 329,
    "468": 330,
    "973": 331,
    "876": 332,
    "107": 333,
    "896": 334,
    "127": 335,
    "916": 336,
    "182": 337,
    "915": 338,
    "914": 339,
    "919": 340,
    "918": 341,
    "913": 342,
    "917": 343,
    "920": 344,
    "927": 345,
    "922": 346,
    "178": 347,
    "926": 348,
    "924": 349,
    "921": 350,
    "925": 351,
    "923": 352,
    "1484": 353,
    "1632": 354,
    "1562": 355,
    "1634": 356,
    "125": 357,
    "700": 358,
    "940": 359,
    "524": 360,
    "814": 361,
    "382": 362,
    "1297": 363,
    "722": 364,
    "929": 365,
    "932": 366,
    "398": 367,
    "1380": 368,
    "800": 369,
    "974": 370,
    "184": 371,
    "971": 372,
    "939": 373,
    "1465": 374,
    "936": 375,
    "934": 376,
    "931": 377,
    "935": 378,
    "938": 379,
    "1539": 380,
    "937": 381,
    "1552": 382,
    "968": 383,
    "1357": 384,
    "1355": 385,
    "1613": 386,
    "1614": 387,
    "1615": 388,
    "944": 389,
    "1239": 390,
    "942": 391,
    "943": 392,
    "1541": 393,
    "952": 394,
    "949": 395,
    "957": 396,
    "1304": 397,
    "139": 398,
    "959": 399,
    "1526": 400,
    "967": 401,
    "955": 402,
    "300": 403,
    "313": 404,
    "176": 405,
    "302": 406,
    "956": 407,
    "953": 408,
    "960": 409,
    "296": 410,
    "295": 411,
    "954": 412,
    "958": 413,
    "1640": 414,
    "1543": 415,
    "1564": 416
}